12 8
111111111111
100000001111
100000000111
100000000001
100000000001
110000000011
111001011011
111111111111
