24 24
111111111111111111111111
100000001111111111111111
100000001111111111111111
100000001111111111111111
100000001111111111111111
100000000000000000000001
100000000000000000000001
100000000000000000000001
100000000000000000000001
100000001100000110000001
100000001000000010000001
100000000000000000000001
100000000000000000000001
100000001000000010000001
100000001100000110000001
100000000000000000000001
100000000000000000000001
100000000000000000000001
100000000000000000000001
111111111111111100000001
111111111111111100000001
111111111111111100000001
111111111111111100000001
111111111111111111111111
