12 8
111111111111
100000001111
100000000111
100000000001
111111111101
110000000001
111001011011
111111111111
