64 64
1111111111111111111111111111111111111111111111111111111111111111
1000000000000000000000000111111111111111111111111111111111111111
1000000000000000000000000000011111111111111111111111111111111111
1000000000000000000000000000000001111111111111111111111111111111
1000000000000000000000000000000000000001111111111111111111111111
1000000000000000000000000000000000000000000111111111111111111111
1000000000000000000000000000000000000000000001111111111111111111
1000000000000000000000000000000000000000000000111111111111111111
1000000000000000000000000000000000000000000000011111111111111111
1111000000000000000000000000000000000000000000000111111111111101
1111110000000000000000000000000000000000000000000111111111100001
1111111111111110000000000000000000000000000000000111111110000001
1111111111111111111111111111000000000000000000000111111110000001
1111111111111111111111111111111000000000000000000111111110000001
1111111111111111111111111111111100000000000000000111111110000001
1111111111111111111111111111111111000000000000000111111110000001
1111111111111111111111111111111111100000000000000111111100000001
1111111111111111111111111111111111111100000000000011111000000001
1111111111111111111111111111111111100000000000000000000000000001
1111111111111111111111111111111111000000000000000000000000000001
1111111111111111111111111111110000000000000000000000000000000001
1111111111111111111111111111100000000000000000000000000000000011
1111111100000011111111100000000000000000000000000000000000000011
1111000000000001111111100000000000000000000000000000000000000111
1100000000000000011100000000000000000000000000000000000001111111
1000000000000000000000000000000000000000001111111010001111111111
1000000000000000000000000000000000001111111111111111111111111111
1000000000000000000000000000000011111111100011111111111111111111
1100000000000000000000000000000000000000000000001111111111111111
1111110000000000000000000000000000000000000000000000000000111111
1111111111111111100000000000000000000000000000000000000000000011
1011111111111111111111100000000000000000000000000000000000000001
1000111111111111111111111111111111111110000000000000000000000001
1000001111111111111111111111111111111111100000000000000000000011
1000001111111111111111111111111111111111110000000000000000000011
1100000111111111111111111111111111111111111000000000000000000111
1110000111111111111111111111111111111111100000000000000000000111
1110000011111111111111111111111111111111000000000000000000000111
1110000000111111111111111111111111111000000000000000000000000111
1100000000000111111111111111111111100000000000000000000000000011
1111000000000000000001111111111000000000000000000000000000000011
1111100000000000000000000000000000000000000000000000000000000011
1111000000000000000000000000000000000000000000000000000000000111
1110000000000000000000000000000000000000000000000000000000000111
1110000000000000000000000000000000000000000000000000000000000111
1110000000000000000000000000000000000000000000000000000000000111
1110000000000000000000000000000000000000000000000000000000011111
1111100000000000000000000000000000000000000000000000000000111111
1111111110000000000000000001111111000000000000000000000000001111
1111111111100000000000001111111111111111100000000000000000000011
1111111111111110000111111111111111111111111111000000000000000011
1111111111111111111111111111111111111111111111110000000000000011
1111111111111111111111111111111111111111111111111110000000000011
1111111111111111111111111111111111111111111111111111110000000011
1111111100000000000000000001111000000111111111111110000000000011
1111110000000000000000000000110000000001111111111111000000000011
1111000000000000000000000000000000000000011111100000000000000011
1100000000000000000000000000000000000000000000000000000000000111
1100000000000000000000000000000000000000000000000000000000011111
1000000000000000000000000000000000000000000000000000000001111111
1000000000111100000000000000000000000000000000000000001111111111
1000000011111110000111100011111000000000000111111111111111111111
1110001111111111101111111111111111100001111111111111111111111111
1111111111111111111111111111111111111111111111111111111111111111
